...#############
...#..S..#..#..#
#..####..#..#..#
#........#.....#
#..#..#..#..#..#
#..#..#.....#..#
#..####..#..####
#..#.F#..#.....#
#..#..#######..#
#.....#.........
#############...